#######
#S...E#
#.###.#
#.....#
#######
