#######
#S....#
#.#.#.#
#.#.#E#
#.....#
#######