#######
#S....#
#.#.###
#...#.E#
#######